zelda
# # # # # # # # # # # # # # # # # # #
# . . . . . . . . . . . . . . . . . #
# . . . . . . . . . . . . . . . . . #
# . . . . . . . . . . . . . . . . . #
# . . . . . . . . . . . . . . . . . #
# . . . . . . . . . . . . . . . . . #
# . . . . . . . . . . . . . . . . . #
X . . . . . . . . . . . . . . . . . X
# . . . . . . . . . . . . . . . . . #
# . . . . . . . . . . . . . . . . . #
# . . . . . . . . . . . . . . . . . #
# . . . . . . . . . . . . . . . . . #
# . . . . . . . . . . . . . . . . . #
# . . . . . . . . . . . . . . . . . #
# # # # # # # # # X # # # # # # # # #
