zelda
# # # # # # # # # X # # # # # # # # #
# . . . . . . . . . . . . . . . . . #
# . . . . . . . . . . . . . . . . . #
# . . . . . . . . . . . . . . . . . #
# . . . . . . . . . . . . . . . . . #
# . . . . . . . . . . . . . . . . . #
# . . . . . . . . . . . . . . . . . #
# . . . . . . . . . . . . . . . . . X
# . . . . . . . . . . . . . . . . . #
# . . . . . . . . . . . . . . . . . #
# . . . . . . . . . . . . . . . . . #
# . . . . . . . . . . . . . . . . . #
# . . . . . . . . . . . . . . . . . #
# . . . . . . . . . . . . . . . . . #
# # # # # # # # # # # # # # # # # # #
