zelda
# # # # # # # # # X # # # # # # # # #
# . . . . . . . . . . . . . . . . . #
# . . . . . . . . . . . . . . . . . #
# . . . . . . . . . . . . . . . . . #
# . . . . . . . . . . . . . . . . . #
# . . . . . . . . . . . . . . . . . #
# . . . . . . . . . . . . . . . . . #
# . . . . . . . . . . . . . . . . . Q
# . . . . . . . . . . . . . . . . . #
# . . . . . . . . . . . . . . . . . #
# . . . . . . . . . . . . . . . . . #
# . . . . . . . . . . . . . . . . . #
# . . . . . . . . . . . . . . . . . #
# . . . . . . . . . . . . . . . . . #
# # # # # # # # # # # # # # # # # # #
