0
.1..
#0#4#4#4#4#4#4#4#4#4#4#4#4#4#4#4#4#4#4#1
#7. . . . . . . . . . . . . . . . . . #5
#7. . . . . . . . $1. . ^3. . . . . . #5
#7. . ^1. . . . . . . . . . . . . . . #5
#7. . . . . . . . . . . . . . . . . . #5
#7. . . . . . . . . . . . . . . $ . . #5
#7. . . . . . . . . . . . . . . . . . #a
#7. . . $1. . . . . . . . . . . . . . .0
#7. . . . . . . . . . . . . . . . . . .0
#7. . . . . . . . . . . . . . . . . . #8
#7. . . . . . . . . . . . . . . . . . #5
#7. . $ . . . . . . . . . . . . . . . #5
#7. . . . . . . . . ^2. . . ^1. . . . #5
#7. . . . ^ . . . . . . . . . . . . . #5
#7. . . . . . . . . . . . . . . . . . #5
#2#6#6#6#6#6#6#6#6#6#6#6#6#6#6#6#6#6#6#3
+000+000
+000+000
+000+000
+000+000
+000+000
