zelda
# # # # # # # # # X # # # # # # # # #
# . . . . . . . . . . . . . . . . . #
# . . . . . . . . . . . . . . . . . #
# . . . . . . . . . . . . . . . . . #
# . . . . . . . . . . . . . . . . . #
# . . . . . . . . . . . . . . . . . #
# . . . . . . . . . . . . . . . . . #
X . . . . . . . . . . . . . . . . . X
# . . . . . . . . . . . . . . . . . #
# . . . . . . . . . . . . . . . . . #
# . . . . . . . . . . . . . . . . . #
# . . . . . . . . . . . . . . . . . #
# . . . . . . . . . . . . . . . . . #
# . . . . . . . . . . . . . . . . . #
# # # # # # # # # # # # # # # # # # #
