zelda
# # # # # # # # # # # # # # # # # # #
# . . . . . . . . . . . . . . . . . #
# . . . . . . . . . . . . . . . . . #
# . . . . . . . . . . . . . . . . . #
# . . . . . . . . . . . . . . . . . #
# . . . . . . . . . . . . . . . . . #
# . . . . . . . . . . . . . . . . . #
X . . . . . . . . . . . . . . . . . #
# . . . . . . . . . . . . . . . . . #
# . . . . . . . . . . . . . . . . . #
# . . . . . . . . . . . . . . . . . #
# . . . . . . . . . . . . . . . . . #
# . . . . . . . . . . . . . . . . . #
# . . . . . . . . . . . . . . . . . #
# # # # # # # # # # # # # # # # # # #
