5
....
.3.3.3r0r4r4r4r4r4r4r4r4r4r4r4r4r1.3.3.3
.3.7.3r7^3^1^0. . . . . . . ^2^1r5.3.7.3
.3.3.3r7. . . . . . . . . . . ^0r5.3.3.3
r0r4r4rb. . . . . . . . . . . . rar4r4r1
r7^0^3. . . . . . . . . . . . . . . ^2r5
r7. . . . . . . . . . . . . . . . . ^0r5
r7. . . . . . . . . . . . . . . . . . r5
r7. . . . . . . . . . . . . . . . . . r5
r7. . . . . . . . . . . . . . . . . . r5
r7. . . . . . . . . . . . . . . . . . r5
r7^1. . . . . . . . . . . . . . . . . r5
r7^2. . . . . . . . . . . . . . . . ^2r5
r2r6r6r9. . . . . . . . . . . . r8r6r6r3
.3.3.3r7^1. . . . . . . . . . ^2r5.3.3.3
.3.7.3r7^0^3^0. . . . . . . . ^2r5.3.7.3
.3.3.3r2r6r6r6r6r6r6r6r6r6r6r6r6r3.3.3.3
